19 19 0
###################
#........X........#
#.#######.#######.#
#.#.............#.#
#.#.#####.#####.#.#
#.#.#.........#.#.#
#.#.#.###.###.#.#.#
#.#.#.#.....#.#.#.#
#.#.#.#.#.#.#.#.#.#
#X.......P.......X#
#.#.#.#.#.#.#.#.#.#
#.#.#.#.....#.#.#.#
#.#.#.###.###.#.#.#
#.#.#.........#.#.#
#.#.#####.#####.#.#
#.#.............#.#
#.#######.#######.#
#........X........#
###################
