18 18 0
##################
#X......##......X#
#.####......####.#
#.#....####....#.#
#.#.#.....####.#.#
#.#.###.#...#..#.#
#...#...###.#....#
#..##.#..#....#..#
##.#..##.P.##.#.##
##.#.##...##..#.##
#..#....#..#.##..#
#....#.###...#...#
#.#..#...#.###.#.#
#.#.####.....#.#.#
#.#....####....#.#
#.####......####.#
#X......##......X#
##################
