26 18 0
##########################
#X.###...#......#...###.X#
#...#..#...#..#...#..#...#
#.#...##..##..##..##...#.#
#.##...#..........#...##.#
#.#..#....#.#..#....#..#.#
#....##..##..#.##..##....#
####.#..............#.####
##.....##...##...##.....##
##......##..##..##......##
####.#..............#.####
#....##..##..#.##..##....#
#.#..#....#.#..#....#..#.#
#.##...#..........#...##.#
#.#...##..##..##..##...#.#
#...#..#...#..#...#..#...#
#X.###...#....P.#...###.X#
##########################
