26 18 1
##########################
#.......#.#.#.#.#.#.#.#.##
#.#.##..................X#
#......#.#.#.#.#.#.#.#.###
######.###################
#......#.#.#.#.#.#.#.#.###
#.#.#...................X#
#.....#.#.#.#.#.#.#.#.#.##
#####.####################
#.....#.#.#.#.#.#.#.#.#.##
#.##....................X#
#....#.#.#.#.#.#.#.#.#.###
####.#####################
#....#.#.#.#.#.#.#.#.#.###
#.#.....................X#
#.#.#.#.#.#.#.#.#.#.#.#.##
#P.......................#
##########################
