26 18 2
##########################
#X....#.....#.....#.....X#
#.#.#...#.#.#.#.#...#.##.#
#.#.#.#.#.#.#.#.###.#.##.#
#.#...#.............#.##.#
#.#.#.###.#####.#.#.#....#
#...#.....#.....#...###..#
#..##.#.#...#.#.#.#.###.##
#...#.#.##....#...#...#.##
###.#.#...#######.###.#.##
#.#.....#.....#.....#.#..#
#.#####.#.#.#.#.#.#.#....#
#.....#...#.#.#.#.#.#.####
#.#.#...###.#.#.#.#.#....#
#.#.###.#...#.#.#.#.#.#.##
#.#...#.#.#.#.#.#.#.#.#.##
#X..#.....#..P....#.....X#
##########################
