26 18
##########################
#X............#.#.#.#.#X##
#.#####.#####.#.#.#.#.#.##
#.............#.#.#.#.#.##
#.#.#.#.#.#.#.#.#.#.#.#.##
#.#.#.#.#.#.#............#
#.#.#.#.#.#.#.#####.######
#.#.#.#.#.#..............#
#P...........#.#.#.#.#.#.#
######.#####.#.#.#.#.#.#.#
#............#.#.#.#.#.#.#
##.#.#.#.#.#.#.#.#.#.#.#.#
##.#.#.#.#.#.............#
##.#.#.#.#.#.#####.#####.#
##.#.#.#.#.#.............#
#.............#.#.#.#.#.##
#X#####.#####.#.#.#.#.#X##
##########################
