26 18 3
##########################
#X............##.##.#.#X##
#.##.##.#.#.#.......#.#.##
#.......#.#.#.#.#.#......#
#.#.#.#.......#.#.#.##.###
#.#.#.#.##.#.............#
#P...........##.##.#.#.#.#
###.##.#.#.#.......#.#.#.#
#......#.#.#.#.#.#.......#
##.#.#.......#.#.#.##.##.#
##.#.#.##.##.............#
#.............##.##.#.#.##
#.##.##.#.#.#.......#.#.##
#.......#.#.#.#.#.#......#
#.#.#.#.......#.#.#.##.###
#.#.#.#.##.#.............#
#X...........##.##.#.#.#X#
##########################
