X                      X
   #   ###   ###   ###  
   #  #   # #   # #   # 
 ###  #   # #   #     # 
   #  #   # #   #   ##  
   #   ####  ####     # 
#  #      #     # #   # 
   #      #     #  ###  
           P            
 #### ### #  # ### ###  
    # # # #  # #   #  # 
   #  # # ## # #   #  # 
  #   # # # ## ##  ###  
 #    # # #  # #   # #  
 #### ### #  # ### #  # 
X                      X