26 18
##########################
#X.............#........X#
#.#.######.##.##.#######.#
#.#......................#
#.#.###.#####.#####.####.#
#.#.#.........#........#.#
#.#.#.###.###.#.##.###.#.#
#.#.#................#.#.#
#...#.##.########.##.#...#
###.#.#.##########.#.#.###
#...#................#...#
#.#.#.##.##.#.###.##.#.#.#
#.#.........#........#.#.#
#.#####.#####.#####.##.#.#
#......................#.#
#.########.##.##.#####.#.#
#X.........#P...........X#
##########################