26 18
##########################
#                        #
#                        #
#                        #
#                        #
#                        #
#                        #
#                        #
#    P      .            #
#                        #
#                        #
#                        #
#                        #
#                        #
#                        #
#                        #
#                        #
##########################
